C:\Users\warre\git\Final-Project\FinalProject\testBG.png
/---/

200000000000000
111111111111110
000000000000000
011111111111111
000000000000000
111111111111110
000000000000000
011111111111111
000000000000000
111111111111110
000000000000000
011111111111111
000000000000000
111111111111110
300000000000000
/---/
0:1;1:1;2:1;3:1;4:1;